11111111111111111111
10000000000000000001
1000P000000C0000E001
1C000000000000000001
11111100000C00000001
100C0000011111111111
11111111111111111111
